w                                 w
w                                 w
w                                 w
w    s                            w
w                                 w
wwwwwwwwwww   wwwwwwwwwwwwwwwwwwwww
w                                 w
w                                 w
w                                 w
w                                 w
w                                 w
wwwwwwwwwwwwwwwwwwwwwwwwwwww      w
w                                 w
w   ee                            w
w   ee                            w
w   ee                            w
w                                 w
wwwwwwwwwwwwwwwwwwwwwwwwwwwwwwwwwww
