w                                 w
w                                 w
w                                 w
w    s                            w
w                                 w
wwwwwwwwwwwwwwwwwwwwwww     wwwwwww
w                                 w
w                                 w
w                                 w
w                                 w
w                                 w
w    wwwwwwwwwwwwwwwwwwwwwwwwwwwwww
w                                 w
w                             ee  w
w                             ee  w
w                             ee  w
w                                 w
wwwwwwwwwwwwwwwwwwwwwwwwwwwwwwwwwww
