w                                 w
w                                 w
w                                 w
w                                 w
w                                 w
w                                 w
w                                 w
w                                 w
w                                 w
w                                 w
w                                 w
w                                 w
w                                 w
w                            ee   w
w                            ee   w
w    s           n           ee   w
w                                 w
wwwwwwwwwwwwwwwwwwwwwwwwwwwwwwwwwww
