w             eeeeeeeee           w
w                                 w
w                                 w
w   s                             w
w                                 w
wwwwwww         wwwwwwwwwwwwww    w
w                                 w
w                                 w
w                                 w
w           n                     w
w                                 w
w    wwwwwwwwwwwwwwwwwwww         w
w                                 w
w                                 w
w                                 w
w        n            n           w
w                                 w
wwwwwwwwwwwwwwwwwwwwwwwwwwwwwwwwwww
