w                                 w
w                                 w
w                                 w
w               n         ee      w
w                         ee      w
www    wwwwwwwwwwwwwwwwwwwwwwwwwwww
w                                 w
w                                 w
w                                 w
w                             n   w
w                                 w
wwwwwwwwwwwwwwwwwwwwww     wwwwwwww
w                                 w
w                                 w
w                                 w
w   s                             w
w                                 w
wwwwwwwwwwwwwwwwwwwwwwwwwwwwwwwwwww
